lie	ne
il	à
Io	le
ta	tu
polir	pour
pour	peur
chie	que
lotit	tout
mare	mère
lit	fit
su	se
due	duc
lu	tu
ta	la
soit	son
las	les
ait	au
dit	du
tue	me
lias	pas
colle	celle
ou	en
ôté	été
dé	de
en	on
pondant	pendant
clans	dans
parait	paraît
nies	mes
porto	porte
taon	mon
Lu	La
volts	vous
peint	point
dons	dans
mémo	même
lit	la
dinar	dîner
raton	mon
fat	fut
parier	parler
ale	de
sort	son
ma	me
prés	près
la	tu
pion	mon
du	de
tâte	tête
cas	ces
centre	contre
aloi	moi
cil	en
tondit	tendit
trais	mais
data	dans
salis	sans
titre	être
clos	des
avilit	avait
lut	lui
sana	sans
duo	que
sas	ses
citez	chez
publie	public
stylo	style
te	le
autour	amour
te	ce
ci	et
biais	Mais
billot	billet
billots	billets
âtre	être
ruais	mais
inonde	monde
ôtes	êtes
pare	père
paris	Paris
parla	par la
bleu	bien
an	au
oie	où
dû	de
dent	don’t
en	eu
votas	vous
ôtaient	étaient
dit	dû
es	as
vaut	veut
lion	lieu
ta	le
lien	lieu
aie	ne
liras	bras
mai	mal
dira	dire
ail	au
soute	seule
lit	là
cour	coeur
partit	parut
sons	sens
vite	vue
lotira	lettre
sent	sont
pus	pas
lu	le
votes	vous
aveu	avec
os	es
an	un
le	la
pins	plus
écrira	écrire
forait	ferait
polit	petit
tilt	un
tour	leur
tir	un
doses	de ses
mois	mais
citer	cher
formé	fermé
tua	ma
passe	pas se
ou	où
Bon	son
pont	peut
pie	de
condor	confier
dais	dans
main	mais
complot	complet
oh	où
colles	celles
colle	cette
pats	plus
due	que
poil	peu
Pleurs	Fleurs
pli	pu
coin	cela
où	au
riait	nuit
pur	par
nue	une
eu	ce
coque	ce que
parle	par le
contrais	connais
coite	cette
perte	porte
porte	perte
pris	pas
crue	que
Riait	Etait
Maires	affaires
mentait	montait
nuis	mais
haut	faut
dis	de
fais	fois
rie	rue
dosa	de sa
mat	mal
mi	un
fait	fût
eu	ou
toits	tous
te	ta
la	ta
pécheur	pêcheur
tort	ton
nier	mer
tout	tant
tondre	tendre
tondant	tendant
des	dès
forme	ferme
trempait	trompait
titi	au
malin	matin
lut	fut
fil	fit
tien	rien
Tien	Bien
la	là
le	te
lie	de
tondait	tendait
une	me
voue	vous
digue	digne
empocher	empêcher
voie	vois
vivra	vivre
doue	donc
inclus	moins
gaie	que
ton	son
frit	fût
ouf	oeuf
un	ne
typo	type
moyeu	moyen
tuas	tu as
roulait	voulait
trous	nous
Je	le
trie	me
tri	ta
fut	fût
aie	de
aile	une
taire	faire
lit	tu
flou	lieu
suais	mais
talus	plus
anal	mal
lin	un
lova	leva
lion	non
flous	nous
sari	son
an	en
ai	si
avalent	avaient
litre	être
fora	fera
sortiront	sortirent
fassent	fussent
dorant	devant
fait	fut
final	mal
fouille	feuille
Fout	Tout
fout	font
foutre	feutre
dirent	diront
faite	fuite
frit	fait
gendre	prendre
de	je
défendra	défendre
femelle	femme
delà	de là
hanta	haute
fausser	hausser
Gomment	Comment
File	Elle
glu	du
dis	dus
dés	dès
dés	des
Gela	Cela
fil	ni
fat	fût
fuit	fait
fille	elle
feux	faux
forai	ferai
fend	fond
et	à
étés	êtes
durs	dans
eau	cou
eaux	ceux
étau	était
formeras	femeras
écoula	écouta
formait	fermait
elfe	elle
folle	folie
en	ce
en	un
font	tant
entra	entre
écouter	écouler
foras	feras
eue	elle
fines	mes
dose	de se
forez	ferez
fit	fût
dota	de ta
dotai	demi
fado	fade
fin	sa
flans	dans
forma	ferma
doua	dans
flirt	fort
flore	Alors
former	fermer
formées	fermées
eu	on
flou	rien
fou	feu
formerais	fermerais
aie	me
lue	lac
aine	une
aine	me
aima	aura
aile	nue
aile	elle
aire	être
aies	ses
ale	me
affluant	affluent
abus	nous
abroger	abréger
souriant	soudant
Justement	Jugement
cirez	chez
ail	un
antre	autre
avère	mère
au	ou
au	on
attrait	aurait
attire	autre
âtres	êtres
aire	dire
apparente	apparence
tonte	toute
amende	amenée
ambre	chère
alto	elle
aloi	ami
alla	elle
ale	un
art	au
eut	eût
sauté	santé
m	ni
ligue	ligne
lieu	rien
intrigues	intrigués
hotte	botte
partis	partie
fie	se
préciserait	précisément
dure	dire
commentait	commençait
commenceront	commencèrent
ayant	avant
altitude	attitude
yeux	veux
fit	et
au	an
là	la
celte	celle
cette	celle
celle	celte
lune	une
dès	des
ne	me
même	môme
Bavait	savait
fit	fît
dos	des
groupes	groupés
jeune	jeûne
urgent	argent
tontes	toutes
me	ne
complots	complets
avertirent	avertiront
contra	contre
continent	comment
connue	comme
connaîtra	connaître
comptent	comment
cotes	côtes
compta	compte
coup	coeur
collé	cette
clous	nous
clone	donc
cloaque	chaque
clic	elle
clé	de
compte	comme
crin	cria
datait	c'était
danse	douce
damer	danger
dais	mais
dais	dois
cul	eut
cosse	cesse
croît	croit
citait	était
crie	cris
criais	mais
creuse	cause
couvres	oevres
cous	vous
cour	pour
crue	être
botte	boîte
cala	cela
Butin	Enfin
bridait	brûlait
bravo	brave
brait	était
brait	bruit
clame	dame
bout	haut
calma	calme
bolide	bonne
bolet	bout
blanche	Manche
benne	bonne
bénie	bénir
de	ce
bovine	bonne
cher cher	chercher
bacon	baron
citais	étais
cirer	cher
loisir	désir
cil	ou
cil	on
calait	valait
cieux	deux
calait	c'était
cher	chez
contre	centre
cendre	vendre
ce	se
casque	chaque
canine	car une
cite	elle
ci	à
sire	sûre
sous	sens
sous	sans
sourira	sourire
sotte	sous
sons	sous
somme	comme
sois	sais
saris	sans
située	aimée
soutes	seules
sertit	sortit
sertie	sortie
sent	sera
sein	seul
savez	soyez
saute	seule
tarit	tard
soigneurs	seigneurs
sus	ans
punirait	pouvait
tao	me
tan	un
taie	une
tai	toi
tacher	tâcher
tache	tâche
sous	vous
sus	ses
soutanes	sommes
suit	son
suie	suis
suai	sur
suai	ami
stère	mère
star	sûr
soutiras	sentiras
sens	sans
ta	à
ramona	ramena
rie	ne
riantes	plantes
rie	de
rua	rue
riantes	nuit
repris	repas
répondra	répondre
saule	seule
recala	recula
rigolos	rigoles
ralenti	retenu
raie	me
loi	la
quoi	quel
hotte	belle
pût	put
pure	père
renais	remis
rue	me
sans	sens
sang	sans
saisiront	saisirent
sais	suis
sains	sans
saga	sage
se	sa
ries	des
rué	rue
ries	ses
routes	rentes
roupie	rouge
roule	route
rivait	avait
rite	rue
rit	fit
Rire	faire
tarte	tête
rucher	rocher
tuas	pas
usais	mais
usa	un
usa	ma
un	on
un	au
tune	tu ne
tues	tu es
tramée	traînée
tue	une
vaisseau	ruisseau
tuait	était
tuai	moi
tuais	mais
trois	crois
tri	tu
trempera	trompera
tao	ne
tuer	mer
vil	vu
vouait	venait
vont	veut
vont	vent
vols	vois
volet	valet
vois	vais
voilure	voiture
va	vu
vitre	votre
vaille	vallée
vienne	Vienne
ventre	venue
ventait	venait
vendant	pendant
veillons	voulons
veau	venu
vaux	veux
traire	croire
voilé	voilà
tel	tu
tient	dont
tics	fils
tics	des
tic	ne
tic	de
tes	les
ternie	terme
treille	trente
telles	celles
tira	ma
tel	toi
te	tu
te	à
taudis	tandis
tau	du
tasse	fasse
tas	pas
tels	cela
tomate	femme
tours	leurs
tour	pour
torts	tous
tonne	tenue
tondus	tendus
tondues	tendues
tondu	tendu
tige	âge
tondis	tandis
tir	tu
tôle	tête
toiture	voiture
toit	ton
toiles	toi les
titi	un
tissez	assez
tire	être
quel	quoi
tondre	rendre
mai	moi
mi	au
met	mot
mène	mère
mats	mais
maison	mais on
mais	puis
maire	affaire
loi	toi
maigre	maître
mis	ans
lutte	luxe
lui	un
lui	qui
lover	lever
loup	leur
lotir	leur
nichée	fâchée
maille	mains
moudras	voudras
ni	ai
nette	cette
néon	mon
pue	que
naine	mine
quoi	moi
mûre	mère
mimait	finissait
mur	coeur
Minable	aimable
moucha	mouche
Mors	Alors
montent	moment
Mon	bien
mois	mots
moi	mot
mit	mît
lit	dit
mure	mère
ion	un
joue	jour
jolie	jour
le	Je
jasais	je sais
ire	ne
iras	pas
ira	ils
Quiche	Guiche
ions	long
lai	ni
ion	ton
inondé	monde
incite	mette
îles	des
île	de
humour	humeur
huis	puis
intime	même
lien	bien
lire	dire
lira	tira
lira	dira
lions	tiens
lion	son
lino	une
lieu	peu
là	le
lier	par
lai	lui
libre	fière
lias	un
liait	huit
liai	lui
lia	un
lasso	lasse
lard	tard
nais	mis
lies	des
petit	peut
plais	plus
plais	mais
plaire	place
pire	père
pion	bien
pies	pas
peut	pont
parles	par les
petit	pour
pliez	chez
pet	pas
pesais	posais
mutation	réputation
pela	cela
noce	mom
pécheurs	pêcheurs
parût	partit
peureux	heureux
port	peut
publia	public
prouve	preuve
prier	parler
prendra	prendre
pourvoir	pour voir
pouffait	pouvait
poste	peste
planque	plan que
porta	porte
plia	du
pondu	pendu
ponctions	poumons
Pomme	femme
poli	peu
pointant	pourtant
plue	plus
plis	pas
peintes	pointes
portes	pertes
nue	me
onde	oncle
on	an
oie	ne
perlait	portait
ocre	être
nuit	naïf
nuit	mit
ont	eût
nuire	mère
ombre	mère
novas	noms
nova	nom
noua	nous
nota	nom
nomme	comme
nominé	nommé
noir	non
nuis	puis
paon	mon
parler	porter
parie	parle
pariant	parlant
oie	en
parc	père
oracle	oncle
pansé	pensé
pan	peu
pan	pas
ors	on
pair	par
outre	entre
où	ce
ôtais	étais
osât	usât
os	as
oraison	maison
pais	pas
parée	parce
jeux	yeux
veux	yeux
fin	un
Four	Pour
tant	tout
tante	toute
I'	l'
tin	un
gène	gêne
peu	pen
