us	as
clown	down
riot	not
Eight	Right
wag	was
thorn	them
Gay	Guy
TUB	THE
mid	and
Borne	Rome
mast	must
oven	even
stones	stories
sonic	some
Ill	In
month	mouth
hie	his
find	and
oar	our
earned	carried
Prom	From
front	from
whore	where
laud	land
Prance	France
hoard	board
an	on
die	the
girt	girl
he	lie
coming	coining
FOB	FOR
Of	or
end	and
oil	on
hare	have
cm	on
live	five
fee	be
Bach	Each
doth	cloth
light	right
beat	best
far	for
readied	reached
is	in
out	our
no	so
Anus	Arms
fee	the
alt	all
surfer	suffer
war	was
PIG	FIG
clone	done
sue	she
110	no
at	as
farther	further
rattier	rather
moat	most
maybe	may be
ate	are
fall	full
buck	back
nave	have
add	and
lip	up
FOE	FOR
grout	great
bands	hands
info	into
are	arc
mail	mall
nest	next
oil	off
fire	five
Aspiration	inspiration
oat	out
tack	back
white	while
lighting	fighting
Mm	him
rip	up
hear	bear
toll	tell
wail	wall
alter	after
Port	Fort
look	took
eves	eyes
oft	off
tittered	uttered
nourished	flourished
got	get
dose	close
ranch	much
bade	back
O	0
move	more
or	of
tor	her
religions	religious
Hail	Hall
religious	religions
tree	free
wore	were
your	year
ram	rain
bold	hold
site	she
area	are a
mail	man
thai	that
jet	yet
both	10th
hit	his
Rut	But
coarse	course
ah	an
Into	late
unable	enable
lier	her
clanger	danger
Beard	Board
OP	OF
lather	father
how	bow
sell	self
in	is
boar	hoar
go	so
eases	cases
tire	fire
wilt	will
fiat	flat
then	their
tins	this
flue	fine
time	true
wind	mind
colt	celt
mad	and
dock	clock
now	new
art	are
hero	here
ills	his
gnus	guns
nut	not
ROW	now
gilt	gift
TEAR	YEAR
cue	one
denned	defined
tide	title
ago	age
mere	more
la	in
life	he
covet	cover
many	marry
mat	not
lancers	dancers
It	If
nay	my
ran	run
mm	him
Tears	Years
If	It
tome	to me
slated	stated
array	army
Pour	Four
out	one
Bear	Rear
hushes	bushes
lean	I can
son	sou
fight	right
ha	he
Iris	his
know	knew
oases	cases
earnest	camest
for	far
fine	line
akin	skin
sea	see
deliriously	deliciously
cage	case
loft	left
winch	which
hall	half
011	on
Home	Rome
mouths	months
mom	morn
Pie	He
lad	had
feet	feel
Hill	will
AH	Ali
along	a long
then	them
snake	make
snore	more
CHATTER	CHAPTER
CHARTER	CHAPTER
food	good
the	she
halt	half
cave	care
them	there
tad	had
Tier	her
set	see
those	these
tis	us
hate	have
Toe	The
tome	home
paid	said
Bout	Boat
crave	gave
baffle	battle
axe	are
persona	persons
Hew	New
email	small
weaned	wearied
cars	ears
hot	not
But	Out
Horns	Home
dram	drain
tiring	bring
best	beat
eon	son
fur	for
nourish	flourish
nagging	flagging
checks	cheeks
righting	fighting
saving	saying
an	as
stem	stern
clays	days
east	case
Bed	Red
slate	state
bean	been
Bat	But
rained	ruined
while	white
Grade	Gracie
Ice	lee
Ids	his
AH	All
OX	ON
stale	state
road	read
Trim	him
eve	eye
fanner	farmer
Best	Rest
primes	prunes
air	as
dawn	down
cut	out
ears	cars
nigh	high
LAME	LAMB
gaming	gaining
bum	burn
icy	joy
best	beet
mined	ruined
alien	Allen
horns	horses
scat	seat
Out	But
hitman	human
Bay	say
hint	him
rill	fill
stern	stem
Tide	This
hay	bay
lily	my
horn	born
ye	we
bring	being
Hood	flood
BOOK	DOOR
held	field
had	bad
thin	this
flatfish	flattish
ladles	ladies
properly	property
flay	May
fie	he
file	the
stud	and
hail	had
clement	element
cot	not
rilled	filled
fell	felt
fed	feel
mutter	matter
begun	began
Header	Reader
shall	shalt
lit	fit
fen	ten
faking	taking
bundled	hundred
Women	woman
snort	short
Given	Green
fast	fact
fry	try
Tour	Your
pie-face	preface
toy	boy
tis	his
became	because
recreating	retreating
turn	him
tour	hour
Person	Poison
are	see
curries	carries
Datives	natives
So	No
ton	too
fin	fig
famish	furnish
under	tinder
BIG	FIG
ether	other
feel	feet
wan	was
post	poet
oxidate	oxalate
toe	foe
Boobs	Books
posts	poets
caress	express
fads	facts
aide	side
rustic	rustle
heir	her
oust	cast
wails	walls
Back	sack
brings	beings
Bide	side
of	or
Bate	Rate
his	hie
side	aide
parson	person
banded	handed
Hear	Near
mow	now
curd	card
Been	seen
festival	aestival
lameness	tameness
aestival	festival
lame	tame
thrash	thrush
bur	our
ip	is
groused	aroused
PRICK	PRICE
plum	plain
skip	ship
full	foil
away	array
foil	full
rate	me
mounded	wounded
saved	served
conies	comes
rum	run
wall	well
looked	locked
bowler	howler
nuns	runs
mattered	muttered
Backcloth	sackcloth
dram	drum
me	the
tin-polished	un-polished
cherry	sherry
fond	lead
stall	still
swill	swift
I low	How
lye	bye
nudes	mules
dope	done
relieve	believe
come	some
ban	man
gunning	sunning
Yak	Yale
One	Dime
efface	of face
Dine	Dime
part	past
Kills	Rifle
BIND	END
ABE	ARE
thief	chief
lifts	life
an	ah
dutch	clutch
fax	far
qualifies	qualities
nice	hire
no	110
rimes	times
aped	aged
%	45
Piddles	Fiddles
toy	by
Rattle	Battle
hid	bid
unsifted	ungifted
Hiring	living
Slime	Shame
Punishing	Publishing
lores	loves
Best	West
Pale	Dale
clog	dog
logs	loss
Halt	Walt
trills	wills
noire	more
act	not
parsed	passed
Breams	Dreams
hear	beer
advent me	adventure
list	fist
line	fine
wild	said
Wearing	Nearing
fast	last
rue	me
stop	step
detective	defective
sloop	sleep
coveting	covering
Hushing	flushing
loud	load
Heir	Herr
Go.	Co.
Cue	fine
nun	man
trails	traits
Hiss	Miss
expanse	expense
Waiter	Walter
coiner	comer
more	swore
Sir	Mr
leafier	leader
seen	Been
Due	Dime
stabs	stairs
tee	here
wafted	walked
111	I'll
Tom	Torn
retained	returned
mall	mail
tiled	tried
rub her	rubber
Jay	lay
gamed	gained
did	die
appeal	appear
ding	wedding
fer	for
caste	came
celling	coming
cow	now
curb	curls
Cut	But
darting	darling
burred	burned
did	old
bunched	launched
doer	door
ears	years
eat	ear
Eke	like
fate	face
fear	for
felling	telling
saying	saving
dialing	chiding
beast	heart
2nd	and
tom	torn
Ac	she
ad	as
agate	again
Agues	Agnes
atone	alone
car	or
bated	hated
few	for
beer	been
bees	been
bet	her
blackhead	blockhead
blew	new
BO	so
borne	house
BOW	now
Aura	down
Jet	let
fending	lending
hove	have
ID	to
If	by
In	to
inmate	inmates
iris	his
hive	have
it	is
hit	he
lace	face
laid	told
Lie	Life
lode	look
lolled	killed
mads	made
mate	make
maw	man
It	fit
ft	it
fie	He
finder	finger
fines	lines
fitting	filling
flight	might
flow	now
fold	told
horn	how
foot	floor
eyes	eves
gel	get
gift	girl
heal	heart
her	he
her	here
hex	her
Hie	the
hist	him
font	but
7	,'
hill	bill
}	]
0	O
0	o
1	l
1	i
7	."
.'	."
7	,"
/'	,"
V	'."
V	".'
V'	'."
'V	".'
hand	band
beard	heard
hest	best
the	die
7	.'
tum	turn
hag	has
cur	our
44	"
Spam	Spain
gram	grain
11	"
guru	gum
{	[
j	;
bis	his
'W	W
"W	W
Mr	Mr.
Mr,	Mr.
Mrs	Mrs.
Mrs,	Mrs.
/	,'
/'	,'
vas	was
10th	both
bill	hill
ear	car
failing	falling
economies	economics
back	bank
wider	under
both	loth
ratter	rather
anal	and
slimmer	summer
porn	form
From	Prom
Mile	Mlle
Mile.	Mlle.
not	hot
case	ease
check	cheek
east	cast
in	iii
hell	bell
hook	book
?	2
hare	bare
bath	hath
bell	hell
hind	bind
hitter	bitter
wore	more
bard	hard
mm	was
bide	hide
hit	bit
rum	ruin
Beep	Keep
mouth	month
vet	yet
1	!
Hose	Rose
hone	bone
meat	moat
sire	are
wet	get
borne	some
lateral	later at
easterner	customer
case	cafe
I've	live
tintings	timings
cockles	cookies
renting	resting
retrained	remained
fill	all
Mine	came
fatuous	famous
Mock	Mode
trill	will
beet	beef
MB	his
thrown	through
men	then
nay	day
pelted	petted
rot	not
saw	save
bench	beach
look	lock
snakes	makes
Night	Eight
to	so
rose	nose
more	mere
bell	boll
dullest	chillest
boil	bolt
jowls	fowls
serial	aerial
hurting	noting
Pans	Paris
there	here
flown	flows
BUMP	RUMP
here-marked	he remarked
react	read
skew	shew
do	no
WOMBS	WOMEN
Molds	Fields
Boast	Roast
hoed	heed
stowed	stewed
cit her	either
hot	loot
shove	shore
Foe	Poe
flat	fiat
nay	may
stealing	steading
hoarding	boarding
rear	roar
our	oar
ramie	made
toe	be
Beads	heads
tight	fight
motors	motory
Tightness	rightness
sot	not
marry	many
wax	war
lies	her
in.	iii.
ml.	vol.
side	skie
chewed	shewed
IS	13
rooks	rocks
lots	lets
encumbers	cucumbers
Airs.	Mrs.
sow	now
love	leave
roots	room
Sampson	Simpson
seeded	needed
sit	sat
smite	smile
soil	son
rick	sick
Sometimes	Sometime
rations	decorations
Surd	Surely
tally	rally
tare	care
tearing	bearing
tee	the
teen	been
ten	tell
tent	sent
soma	some
OR	on
111	Ill
mot	not
mottling	morning
ms	me
mt	at
mud	and
of	by
ride	side
OK	on
test	best
OS	on
ottered	offered
OWE	own
paster	master
peek	week
pilling	willing
prepaying	repaying
present	presence
oil	oh
whoa	when
totter	latter
tow	low
tut	but
vary	very
wait	went
Wee	like
weekly	meekly
Tessie	Jessie
west	went
took	look
beach	bench
beets	been
comers	corners
Eves	lives
fetter	letter
hi	he
innocence	ignorance
mil	all
Wended	blended
tint	that
lock	look
Thai	Then
Thea	Then
theft	then
them	then
those	chose
tight	sight
tilings	things
top	too
tilt	the
toots	boots
tints	thus
tips	lips
title	true
to	in
toe	too
togging	tugging
tong	long
test	last
till	bill
night	flight
Outs	Oats
fluster	cluster
blank	black
tilled	filled
sill	fill
buys	boys
dosing	closing
Tin	The
wild	who
mode	made
raised	used
tint	the
tiring	firing
I	He
waring	waving
game	same
pardon	garden
lint	but
tipper	upper
dialed	dialect
Indies	ladies
tile	file
attain	again
Greek	Creek
nigh	rush
wider stand	understand
fray	pray
miracles	curacies
often	of ten
RAVE	HAVE
icing	king
udder	under
Book	Rook
under	udder
much	such
Bound	Round
is sited	issued
Hare	Rare
ostentations	ostentatious
derails	details
Ill	If
decree	degree
allow	show
cairn	calm
Rights	flights
verifiable	vitrifiable
pact	part
night	might
BEHOVED	REMOVED
patted	pasted
Royals	Royale
Hi:	He
wafers	waters
formers	farmers
tin's	this
concerted	converted
fed	feet
mollification	mortification
wont	want
un-parted	imparted
horn	from
Fool	Pool
Core	ashore
fright	right
pest	best
take	sake
rims	runs
inflection	reflection
roost	most
Crow	Grow
puts	cuts
supped	slipped
bike	like
carnages	carriages
dement	element
dement	clement
Pig.	Fig.
token	taken
Id	in
Mend	friend
Rat	flat
trod	tread
substantiate	substantials
unrelieved	is relieved
mound	wound
sear	scar
academics	academies
home	house
shaft	shall
minder	murder
daring	during
Lathe	lithe
fall	tall
decimation	declaration
1813	ISIS
Homo	Home
lie	be
fill	till
fret	free
pays	says
ice	we
muster	master
Tack	Pack
tiny	any
Paddy	Daddy
fie	the
Aw	An
Joying	loving
Gist	first
hooked	booked
dullness	chillness
reeked	recked
months	mouths
cf	of
eared	cared
freezes	breezes
lame	fame
led	bed
lingers	fingers
nagged	flagged
ore	one
worm	worth
race	face
tightly	lightly
rook	rock
urn riled	married
Ware	blare
Wood	blood
MESSES	MESSRS
Bather	Rather
spill	soul
magpie	magic
peach	Bench
pare	page
Fate	Fats
See	&c
Hag	flag
tuck	trick
turn	torn
cad	and
voting	young
howls	bowls
frustrations	Illustrations
centimes	centuries
sold	acid
and	any
said	acid
diem	them
Boot	Root
ponder	powder
slightest	straightest
amended	ascended
complied	compiled
latent	talent
illegitimate	a legitimate
land	kind
as	at
will	with
dub	club
hallowed	bellowed
Ken	lien
Hides	Hicks
tilled	called
men	When
rods	rode
muffle	shuffle
nib	rub
Else	Rise
Hanoi	Honor
forked	worked
helium	bellum
Primed	Printed
beet	been
Thai	The
fairing	falling
fine	give
lore	love
shrill	shall
curs	ours
&	a
attentions	affections
foloi wed	followed
Cubes	Cures
levels	jewels
ail	an
rather	Father
masked	marked
1ST	IN
elopes	slopes
injures	insures
OATS	CATS
sneak	speak
dive-tea	divorce
denied	defiled
gee	see
Dane?	Dance
Amelia	Aurelia
Rive	give
Hubert	Robert
Die	he
SIX	SIR
BEGAT	LEGAL
blackboard	buckboard
obligate	obligato
Games	Causes
bend	head
nude	made
stains	status
jot	jet
gist	21st
Dill	Hill
worsen	women
haply	Apply
urn	um
begs	bees
endured	engaged
listing	History
utter	under
Latex	Lately
Annie	Runic
Crones	Crosses
hanger	hunger
lauds	lands
Bond	Road
Mat	May
net	act
cure	care
continuation	confirmation
cutler	cutter
stops	steps
typo	type
fins	form
suck	such
tinge	time
ultimately	intimately
roe	me
dippers	slippers
dipper	clipper
Pea	Pen
outbids	outside
PARIS	PARTS
GOO	GOD
moans	means
are	and
pot	put
wound	around
bold	held
apes	apex
stipple	supple
Occupation	Occultation
goad	good
Ill	his
preached	preachers
Club	Glut
euro	curb
denies	defiles
short	shore
eave	gave
matters	patters
each	such
Prudent	President
both	bath
PUKE	DUKE
mother	another
read or	reader
fit teen	fifteen
Writing	Hunting
its	us
hum	him
men	seen
timer	time,
full	fell
baud	band
baud	hand
TAG!	PAGE
log	109
passible	possible
lone	tone
groat	great
Arable	Arabic
contend	content
Mushing	blushing
scouring	scouting
abort	short
sloth	cloth
Severs	covers
gender	sender
mere	there
east	ease
poof	poor
Twos	Twas
put	out
assort	assert
delirously	deliciously
marrow	morrow
superstitions	superstitious
map	man
stoic	stole
tarried	carried
Hue	line
clear	dear
cornet	comet
get	set
cornets	comets
surged	urged
tame	came
shorts	shores
vended	rended
Hum	Burn
tailed	called
patched	watched
tool	too!
herd	hard
dear	clear
fill	511
lieu tenant	lieutenant
vent	went
fin	An
whose	whoso
yo	you
this	the
homeland	home, and
has	his
Pool	Poor
organisation	organization
Sin	Sir
nation	notion
Set.	Sci.
Bays	says
looting	looking
Beat	seat
millions	migrations
loss	less
big	his
eve ring	evening
bewail	began
SACKED	SACRED
seat	sent
intolerably	it tolerably
Hew	Few
seemed	secured
over	ever
OK	OF
Rob	Bob
Bob	Rob
sadden	sudden
fooled	footed
waves	leaves
Mold	Hold
imagination	invagination
loots	looks
sec	see
suspicious	suspicons
ax	as
harry	carry
till	all
and	find
Or,	On
Toy	Joy
MARKS	MAKES
had	lid
Past	Fast
Host	Most
Hoofing	Roofing
inch	men
crone	gone
TV	the
towing	rowing
Fork	York
Bought	sought
cowards	towards
beak	locale
boasts	houses
Pair	Fair
Fair	Pair
ox	or
an	all
harmonica!	harmonical
soap	soup
passed	paused
hid	his
tire	the
passed	lessen
Bast	East
rub	rule
heat	meat
arid	acid
Pear	Fear
she	sin
them	evilly
not	flint
have	lave
horde	home
had	lead
CLIPBOARD	CUPBOARD
your	yolk
with	wily
had	libel
amply	ally
rivet	river
sand	and
defined	defiled
pheasant	pleasant
nans	nuns
at	lit
tower	lower
cored	cured
neat	near
Erects	Effects
Rerun	Berlin
ii	it
Do	De
banger	banter
awl	all
suspicious	auspicious
weir	well
Teachings	reachings
clogs	dogs
presses	tresses
terry	ferry
five	give
frights	nights
balls	halls
nickered	flickered
Banged	Ranged
Brawn	Brown
Blade	Black
Icings	kings
TEX	TEN
rent	cent
ivories	works
menus	means
anode	an ode
sill	sin
loud	Lord
Handiest	bloodless
toe	we
suite	spite
king	lung
fife	five
lull	full
lust	fast
Beadily	Readily
freight	height
shaded	shaped
smear	swear
oh	on
quartet	quarter
Negation	Notation
lung	king
drags	drugs
11 is	His
won!	word
sod	and
mole	made
dome	done
Pat	Put
navel	novel
swanning	swarming
show	snow
song	sang
hang	hung
meaning	moaning
wonder	wander
bonding	bending
son!	soul
PACK	PAGE
STASIS	STARTS
next	next
Beading	Reading
hunched	hundred
lie	the
Hour	flour
hooka	books
Tail	Ball
car	our
land	bold
ants	and
bang	being
fetal	fatal
weasels	vessels
five	fire
tie	de
arid	add
destroyer	destroy or
Into	into
o	of
oven	over
MEW	NEW
eliding	ending
naming	flaming
rent	refit
erase	case
stilt	still
ton	top
occupations	occulations
baa	has
Jaw	law
rim	run
natter	flatter
otter	offer
tars	cars
lay	day
next	neck
Beg.	Reg.
used	need
nights	flights
Romeo	Borneo
element	clement
piano	plane
mariners	manners
manners	mariners
syllable	syllabic
skull	shall
astern	a stem
fiction	action
rend	road
leader	reader
new	now
worm	would
dubs	clubs
late	fate
Tea	Yea
gays	says
sinking	singing
toilers	boilers
Some	Rome
Track	Tract
Lot	Let
Tract	Track
loyal	royal
older	order
dining	during
acorn	a corn
hounds	bounds
ray	raw
Dark	bark
lakes	takes
illusion	mission
Rome	Some
nil	fill
lees	less
mam	main
draped	dragged
bailing	hailing
oft	on
appeased	appeared
skip	skin
patty	party
aft	an
kid	laid
axial	social
rush	cash
rod	red
curt	cart
parries	parties
titan	than
day	say
linked	planked
disposal	disposed
it	a
meanings	moanings
ruin	rain
altitude	attitude
yelled	veiled
well	we'll
route	mute
on	off
stops	stores
tooth	100th
has-relief	bas-relief
easting	casting
fake	false
busk	husk
spade	space
soars	scars
fellow	follow
follow	fellow
lull	Hill
beet	bed
yarn	vain
frying	trying
theft	their
thy	the
Hearing	nearing
Partial	Portugal
than	then
sevens	screens
He	We
Iamb	lamb
Pox	fox
rolled	robed
impressed	unpressed
cornea	comes
List	last
111	in
glares	gives
former	farmer
straggle	struggle
toss	loss
Plenty	Henry
mom	room
Ride	Rule
dunk	think
(old	fold
All	Ali
Conduit	Conduct
nationalist	rationalist
adroit	admit
aa	as
Christ;	Christy
heaving	hearing
net	set
worn an	woman
Air.	Mr.
Kite	like
quartet	quarters
hearings	bearings
COED	CORD
oral	oval
Buns	Runs
dung	clung
pound	sound
Large	barge
sad	and
seances	stances
Gnome	Chrome
rums	ruins
checked	cheeked
Urn	him
aids	axis
lilted	lifted
man	than
sour	soup
growl	grow
Blight	Bright
some	same
gashes	gushes
oilier	other
liver	river
18Th	1875
ground	around
nicker	flicker
tine	the
polities	politics
rebellions	rebellious
genetically	generically
suite	suits
scaled	sealed
elites	class
ox	of
duly	duty
Nerd	Herd
salt	sail
tames	tarries
Ami	And
tilt	till
Daughter	Laughter
tunes	times
hour	how
tilling	filling
bock	back
fad	fact
Hold	Held
Pact	past
duets	ducts
hale	hole
yam	yarn
Sips	dips
kind	band
Fanning	Farming
mare	make
root	roof
appeal's	appears
Held	Hold
Dot	not
waiting	writing
nesting	resting
hone	home
chanty	charity
recount	account
Ill	I'll
Slays	Slavs
oiler	offer
Eva:	Ever
Signer	Signor
tram	from
HAKE	HARE
FACE	PAGE
Pacing	Facing
Pate	Fate
trench	French
welt	well
coat	cost
cost	coat
cheeked	checked
We	love
leafing	loafing
boot	book
boots	books
Literary	Library
cup	cap
throw	threw
hint	hurt
maul	main
nukes	makes
relate	relapse
starring	starving
hind	land
dark	Clark
wiry	why
banquets	bouquets
FEINTED	PRINTED
intrudes	intricacies
wall	will
If	I?
gratis	grain
trow	brow
men	man
boarding	hoarding
BEEP	BEEF
