eu	en
on	en
a	à
peur	pour
pou	peu
nie	me
ou	eu
ôtait	était
tète	tête
sou	son
niais	mais
nia	ma
la	le
Riais	Mais
doux	deux
sa	se
voua	vous
cotte	cette
ou	on
II	Il
on	ou
mou	mon
celte	cette
do	de
ll	Il
fît	fit
môme	même
11	Il
où	on
celle	cette
noire	notre
à	a
rosé	rose
