ans	aus
schlössen	schlossen
bat	hat
mau	man
Hessen	liessen
ans	uns
Glänze	Glanze
heim	beim
Bann	Dann
betrügt	beträgt
Fülle	Fälle
Ober	über
eisern	einem
lob	ich
Mindern	sondern
gebuchte	gesuchte
öder	der
schliche	schliesse
bestellen	bestehen
Bache	Rache
Karren	Narren
aus	uns
nie	sie
uns	aus
Wort	Wert
uns	was
Bögen	Bösen
grüneres	grösseres
Hechte	Rechte
Hecht	Recht
Baum	Raum
Absehen	Abscheu
Losung	Lösung
Mais	Maß
Abo	Abc
Schütze	Schutze
Wurde	Würde
Ton	Von
entferntem	entferntern
liege	liess
nur	mir
bandelt	handelt
gewännen	gewinnen
schwacher	schwächer
beute	heute
Bade	Bude
Hanse	Hause
Bande	Rande
Kufe	Rufe
Per	Der
Räume	Raume
stände	stande
Staatsbürger	Staatsbücher
Mich	sich
fährt	führt
zugehen	zugeben
Trank	Trunk
da	du
Grunde	Gründe
Füllen	Fällen
Warme	Wärme
schössen	schossen
des	den
um	uns
Räumen	Bäumen
altem	allem
oben	eben
