"W	W
'V	".'
'W	W
.'	."
/	,'
/'	,"
/'	,'
?	2
{	[
}	]
0	o
0	O
1	!
1	i
1	l
10th	both
11	"
111	Ill
2nd	and
44	"
7	,"
7	,'
7	."
7	.'
Ac	she
ad	as
agate	again
Agues	Agnes
Airs.	Mrs.
akin	skin
alien	Allen
alt	all
an	on
anal	and
at	as
atone	alone
Aura	down
back	bank
bade	back
bands	hands
Bat	But
Bate	Rate
bated	hated
bath	hath
beach	bench
Beads	heads
bean	been
beard	heard
beast	heart
BEEP	BEEF
beer	been
bees	been
beet	beef
beets	been
bell	boll
bell	hell
bet	her
blackhead	blockhead
blew	new
BO	so
boarding	hoarding
Boast	Roast
boil	bolt
borne	house
Borne	Rome
borne	some
both	10th
both	loth
BOW	now
bowler	howler
bum	burn
BUMP	RUMP
bunched	launched
bundled	hundred
bur	our
burred	burned
car	or
cars	ears
case	cafe
case	ease
caste	came
celling	coming
check	cheek
chewed	shewed
cit her	either
clone	done
cm	on
coarse	course
cockles	cookies
comers	corners
coming	coining
conies	comes
cot	not
covet	cover
cow	now
crave	gave
cue	one
cur	our
curb	curls
Cut	But
darting	darling
denned	defined
dialing	chiding
did	old
die	the
ding	wedding
do	no
dock	clock
doer	door
doth	cloth
dram	drain
dullest	chillest
ears	years
eases	cases
easterner	customer
eat	ear
Eight	Right
Eke	like
encumbers	cucumbers
end	and
ether	other
eve	eye
eves	eyes
Eves	lives
faking	taking
fall	full
far	for
fate	face
fatuous	famous
fear	for
fed	feel
fee	be
fee	the
feet	feel
fell	felt
felling	telling
fen	ten
fending	lending
fer	for
fetter	letter
few	for
fie	he
fie	He
fight	right
file	the
fill	all
fin	fig
find	and
finder	finger
fines	lines
fitting	filling
flat	fiat
flight	might
flow	now
flown	flows
FOB	FOR
FOE	FOR
Foe	Poe
fold	told
font	but
foot	floor
From	Prom
fry	try
ft	it
gaming	gaining
Gay	Guy
gel	get
gift	girl
girt	girl
Grade	Gracie
gram	grain
guru	gum
ha	he
hack	back
had	bad
hag	has
hail	had
hare	have
he	be
he	lie
heal	heart
her	he
her	here
here-marked	he remarked
hest	best
hex	her
hi	he
hie	his
Hie	the
hind	bind
hist	him
hit	he
hit	his
hive	have
hoard	board
hoarding	boarding
hoed	heed
Home	Rome
horn	how
hot	loot
hot	not
hove	have
hurting	noting
I've	live
Ice	lee
ID	to
If	by
ills	his
in	iii
In	to
in.	iii.
info	into
inmate	inmates
innocence	ignorance
Iris	his
iris	his
IS	13
is	in
It	fit
it	is
j	;
Jet	let
jowls	fowls
know	knew
la	in
lace	face
lad	had
laid	told
lameness	tameness
lateral	later at
Lie	Life
lie	the
lier	her
lies	her
light	right
lip	up
lock	look
lode	look
lolled	killed
look	lock
look	took
looked	locked
lots	lets
love	leave
mad	and
mads	made
many	marry
marry	many
mast	must
mat	not
mate	make
maw	man
maybe	may be
MB	his
me	the
meat	moat
men	then
mid	and
mil	all
Mile.	Mlle.
Mine	came
mined	ruined
ml.	vol.
mm	him
Mm	him
mm	was
Mock	Mode
Molds	Fields
mom	morn
more	mere
mot	not
motors	motory
mottling	morning
Mr	Mr.
Mr,	Mr.
Mrs	Mrs.
Mrs,	Mrs.
ms	me
mt	at
mud	and
nay	day
nay	may
nay	my
nest	next
Night	Eight
no	so
not	hot
nourish	flourish
O	0
oar	our
of	by
Of	or
of	or
oil	off
oil	oh
oil	on
OK	on
OP	OF
OR	on
OS	on
ottered	offered
oust	cast
out	one
oven	even
OWE	own
oxidate	oxalate
Pans	Paris
parson	person
paster	master
peek	week
pelted	petted
persona	persons
Pie	He
pilling	willing
porn	form
Pour	Four
Prance	France
prepaying	repaying
present	presence
Prom	From
ram	rain
ramie	made
rations	decorations
ratter	rather
rattier	rather
react	read
readied	reached
rear	roar
renting	resting
retrained	remained
rick	sick
ride	side
riot	not
rooks	rocks
roots	room
rose	nose
rot	not
ROW	now
rustic	rustle
Sampson	Simpson
saved	served
saw	save
seeded	needed
serial	aerial
set	see
shall	shalt
shove	shore
side	skie
sire	are
sit	sat
skew	shew
slimmer	summer
smite	smile
snake	make
snakes	makes
snore	more
snort	short
soil	son
soma	some
Sometimes	Sometime
sonic	some
sot	not
sow	now
Spam	Spain
stealing	steading
stowed	stewed
sue	she
Surd	Surely
tad	had
tally	rally
tare	care
tearing	bearing
Tears	Years
tee	the
teen	been
ten	tell
tent	sent
Tessie	Jessie
test	best
test	last
thai	that
Thai	Then
the	she
Thea	Then
theft	then
them	then
them	there
there	here
thorn	them
those	chose
those	these
thrown	through
Tier	her
tight	sight
Tightness	rightness
tilings	things
till	bill
tilt	the
tin-polished	un-polished
tinder	under
tint	that
tintings	timings
tints	thus
tips	lips
tis	his
title	true
tittered	uttered
to	in
to	so
toe	be
toe	foe
toe	too
togging	tugging
tome	home
tome	to me
ton	too
tong	long
took	look
toots	boots
top	too
tor	her
totter	latter
Tour	Your
tow	low
toy	boy
trill	will
TUB	THE
tum	turn
tut	but
us	as
V	".'
V	'."
V'	'."
vary	very
vas	was
vet	yet
wag	was
wait	went
wall	well
war	was
wax	war
Wee	like
weekly	meekly
Wended	blended
west	went
wet	get
white	while
whoa	when
whore	where
wider	under
wind	mind
WOMBS	WOMEN
wore	more
