lie	he
arid	and
yon	you
he	be
be	he
bad	had
tip	up
tho	the
arc	are
hut	but
tiling	thing
bat	but
Ms	his
tune	time
coining	coming
hi	in
ho	he
tor	for
hack	back
tie	he
tinder	under
ail	all
tier	her
fee	he
die	she
docs	does
lime	time
ease	case
ray	my
ringers	fingers
fail	fall
bow	how
clay	day
is	as
borne	home
m	in
modem	modern
cast	east
bar	her
bear	hear
cheek	check
carnage	carriage
boon	been
car	ear
band	hand
ball	hall
carne	came
tile	the
u	"
ho	who
bo	be
tight	right
bit	hit
wen	well
haying	having
rioted	noted
cat	cut
tie	the
ringer	finger
ray	away
loth	10th
1	I
comer	corner
cat	eat
tram	train
bumbled	humbled
bead	head
beads	heads
