10th	loth
2	?
55	"
60th	both
ab	ah
act	art
aerial	serial
al	ai
ali	all
all	ail
all	fill
Allen	alien
and	2nd
and	anal
and	arid
anger	auger
are	arc
are	sire
as	is
as	us
auger	anger
away	ray
b	h
back	hack
bands	hands
bang	hang
bank	back
bard	hard
bare	hare
barn	ham
barry	harm
barry	harry
bas	has
baste	haste
bat	hat
bath	hath
baud	bend
bay	hay
bc	be
bc	he
be	toe
bean	beau
bearing	hearing
bears	hears
beat	heat
beating	heating
beau	bean
beef	beet
been	beets
been	boon
Beep	Keep
bench	beach
bend	baud
best	hest
bide	hide
Bight	Right
bill	hill
bills	hills
bind	hind
bis	his
bits	hits
bitter	hitter
board	hoard
bold	hold
boll	bell
bone	hone
book	hook
books	hooks
born	horn
born	how
bot	but
bot	hot
both	60th
bound	hound
bouse	house
bow	born
bowl	howl
boy	hoy
bp	hp
bull	hull
bunch	hunch
bunt	hunt
burn	bum
burned	hurried
bush	hush
but	bat
but	hut
by	hy
c	e
cafe	case
came	carne
came	carrie
came	Mine
carriage	carnage
carrie	came
carried	earned
case	ease
cased	eased
cases	eases
cd	ed
checks	cheeks
cheeks	checks
chill	dull
chillest	dullest
chilly	dully
cloth	doth
cm	cry
cock	code
code	cock
coin	cow
coins	cows
cookies	cockles
corn	coin
corn	cow
corner	comer
course	coarse
cow	coin
cow	corn
cows	coins
cry	cm
cucumbers	encumbers
custom	eastern
customer	easterner
cut	cat
damn	dawn
dawn	damn
day	clay
day	tiny
dc	de
de	dc
does	docs
drain	dram
drain	draw
draw	drain
dull	chill
dully	chilly
e	c
ear	car
earned	carried
ears	cars
eased	cased
east	cast
eastern	custom
eat	cat
economics	economies
economies	economics
ed	cd
Eight	Night
even	oven
eye	eve
eyes	eves
failing	falling
fails	falls
fall	fail
falling	failing
falls	fails
fame	fate
famous	fatuous
Fasting	Pasting
fate	fame
fiat	flat
Fields	Molds
fight	tight
File	Pile
files	flies
Fill	Pill
finger	ringer
fingers	ringers
flies	files
floor	flour
flour	floor
flourish	nourish
flows	flown
for	far
form	porn
Four	Pour
fowls	jowls
gain	gary
gaining	gaming
gary	gain
go	so
Gracie	Grade
grain	gram
gum	guru
h	b
hall	ball
ham	barn
hand	band
hands	bands
hang	bang
hard	bard
hare	bare
harm	harry
harry	barry
harry	harm
has	bas
has	hag
haste	baste
hat	bat
hath	bath
having	haying
hay	bay
he	lie
He	Pie
head	bead
heads	beads
heads	Beads
hear	bear
heard	beard
hearing	bearing
hears	bears
heat	beat
heating	beating
heed	hoed
hell	bell
her	lier
her	lies
here	hero
hero	here
hide	bide
hill	bill
hills	bills
him	hint
hint	him
his	bis
his	ills
his	Ms
hit	bit
hits	bits
hitter	bitter
hold	bold
home	borne
home	to me
hone	bone
hook	book
hooks	books
horn	born
Hose	Rose
hound	bound
Hound	Round
house	bouse
how	bow
howl	bowl
hoy	boy
hp	bp
hull	bull
humbled	bumbled
hunch	bunch
hunt	bunt
hurried	burned
hush	bush
hy	by
I	!
ice	lee
ie	le
iii	ill
Ill	111
ill	iii
inc	me
inc	we
inn	run
Keep	Beep
knew	know
l	i
land	laud
later at	lateral
laud	land
le	ie
lee	ice
lee	Ice
lets	lots
live	I've
locked	looked
locks	looks
looks	locks
loot	hot
mail	wall
main	mary
main	warn
make	wake
males	wales
married	warned
marry	warm
mary	main
match	watch
matched	watched
matching	watching
may	nay
may	way
may be	maybe
me	we
mere	were
merit	went
met	wet
mild	wild
Mile	Mlle
mill	will
mind	wind
minds	winds
mine	wine
mines	wines
Mlle	Mile
Mlle.	Mile.
mm	win
moat	meat
mock	mode
mode	mock
Mode	Mock
modern	modem
month	mouth
mood	wood
more	wore
motory	motors
mouth	month
Mr.	Mr
Mr.	Mr,
Mrs.	Mrs
Mrs.	Mrs,
my	ray
next	nest
no	do
nose	rose
not	rot
not	sot
noted	rioted
noting	hurting
o	0
ob	oh
oh	ob
our	cur
our	oar
Paris	Pans
Pasting	Fasting
Pile	File
Pill	Fill
pin	pm
pm	pin
Rack	Back
rain	ram
ram	raw
rather	ratter
raw	rain
Re	Be
reached	reacted
reacted	reached
read	react
remained	retrained
Right	Bight
Right	Eight
right	fight
right	tight
rightness	tightness
rise	use
rises	uses
rising	using
roar	rear
Roast	Boast
rocks	rooks
Rome	Borne
Rome	Home
Rose	Hose
rote	note
ruin	rum
ruined	mined
rum	ruin
RUMP	BUMP
run	inn
Rut	But
salts	waits
sam	saw
save	saw
saving	saying
saw	sam
saying	saving
scat	seat
seat	scat
shew	skew
shore	shove
skie	side
skin	akin
slimmer	summer
so	go
so	to
some	borne
Spain	Spam
steading	stealing
stein	stem
stem	stein
stem	stern
stern	stem
stewed	stowed
stones	stories
stories	stones
strain	straw
straw	strain
summer	slimmer
tail	tall
tall	tail
term	terry
terry	term
the	die
the	lie
the	tho
the	tie
the	tile
them	thorn
these	those
thing	tiling
through	thrown
tic	tie
tight	fight
tightness	rightness
time	lime
time	tune
timings	tintings
tin	try
tiny	day
to me	tome
tom	torn
tom	tory
torn	tom
torn	tory
tory	tom
train	tram
try	tin
turn	tum
under	wider
up	lip
up	tip
use	rise
uses	rises
using	rising
von	you
w	in
w	m
waits	salts
wake	make
wales	males
wall	mail
war	wax
warm	marry
warn	main
warn	mary
warned	married
was	vas
was	wag
watch	match
watched	matched
watching	matching
way	may
we	inc
we	me
well	wen
went	merit
were	mere
wet	met
where	whore
who	ho
wild	mild
will	mill
will	trill
win	mm
winds	minds
wine	mine
wines	mines
WOMEN	WOMBS
wood	mood
wore	more
y	v
yet	vet
you	von
you	yon
